**************************'^***********^^^*
**^^*^^^^^^^^^^^^^^^^^****'^^**^^^^^^^^^^^^
***^^^^^^^^^^^^^^^^^^^^^**'^^^^^^^^^^^^^^^^
**^^^^^^^^^^^^^^^^^^^^^***'^^^^^^^^^^^^^^^^
*^^^^^^^^^^^^^^^^^^^^^^^**c"""""""""""'^^^^
^^^^^^^^^^^^^^^^^^^^^^^^^*^^^^^^^^^^^^'^^^^
^^^^^^^^^^^^^^^^^^^^^^^^^^^^^^^^^^^^^^'^^^^
^^^^^^^^^^^^^^^^^^^^^^^^^^^^^^^^^^^^^^'^^^^
^^^^^^^^^^^^^^^^^^^^^^^^^^^^^^^^^^^^^^'^^^^
^^^^^^^^^^^^^^^^^^^^^^^^^^^^^^^^^^^^^^'^^^*
Pppppppppppppppppppppppppppppppppp^^^^'^^**
^^^^^^^^^^^^^^^^^^^^^^^^^^^^^^^^^^^^^^'^^^*
^^^^^^^^^^^^^^^^^^^^^^^^^^^^^^^^^^^^^^'^^^^
^^^^^^^^^^^^^^^^^^^^^^^^^^^^^^^^^^^^^^'^^^^
^^^^^^^^^^^^^^^^^^^^^^^^^^^^^^^^^^^^^^c"/""
^^^^^^^^^^^^^^^^^^^^^^^^^^^^^^^^^^^^^^^^^**
^^^^^^^^^^^^^^^^^^^^^^^^^^^^^^^^^^^^^^^^^^*
^^^^^^^^^^^^^^^^^^^^^^^^^^^^^^^^^^^^^^^^^^^
*****************************************^^