*******************************************
**^^*^^^^^^^^^^^^^^^^^*********^^^^^^^^^^^*
***^^^^^^^^^^^^^^^^^^^^^**^^^^^^^^^^^^^^^^*
**^^^^^^^^^^^^^^^^^^^^^^^^^^^^^^^^^^^^^^^^*
*^^^^^^^^^^^^^^^^^^^^^^^^^^^^^^^^^^^^^^^^^*
^^^^^^^^^^^^^^^^^^^^^^^^^^^^^^^^^^^^^^^^^^*
^^^^^^^^^^^^^^^^^^^^^^^^^^^^^^^^^^^^^^^^^^*
^^^^^^^^^^^^^^^^^^^^^^^^^^^^^^^^^^^^^^^^^^*
^^^^^^^^^^^^^^^^^^^^^^^^^^^^^^^^^^^^^^^^^^*
^^^^^^^^^^^^^^^^^^^^^^^^^^^^^^^^^^^^^^^^^^*
Ppppppppppppppppppppppppppppppppppppppppppp
^^^^^^^^^^^^^^^^^^^^^^^^^^^^^^^^^^^^^^^^^^*
^^^^^^^^^^^^^^^^^^^^^^^^^^^^^^^^^^^^^^^^^^*
^^^^^^^^^^^^^^^^^^^^^^^^^^^^^^^^^^^^^^^^^^*
^^^^^^^^^^^^^^^^^^^^^^^^^^^^^^^^^^^^^^^^^^*
^^^^^^^^^^^^^^^^^^^^^^^^^^^^^^^^^^^^^^^^^^*
^^^^^^^^^^^^^^^^^^^^^^^^^^^^^^^^^^^^^^^^^^*
^^^^^^^^^^^^^^^^^^^^^^^^^^^^^^^^^^^^^^^^^^*
*******************************************