***************************************"^^*
**^^*^^^^^^^^^^^^^^^^^*********^^^^^^^^"^^^
***^^^^^^^^^^^^^^^^^^^^^**^^^^^^^^^^^^^"^^^
**^^^^^^^^^^^^^^^^^^^^^^^^^^^^^^^^^^^^^"^^^
*^^^^^^^^^^^^^^^^^^^^^^^^^^^^^^^^^^^^^^"^^^
^^^^^^^^^^^^^^^^^^^^^^^^^^^^^^^^^^^^^^^"^^^
^^^^^^^^^^^^^^^^^^^^^^^^^^^^^^^^^^^^^^^"^^^
^^^^^^^^^^^^^^^^^^^^^^^^^^^^^^^^^^^^^^^"^^^
^^^^^^^^^^^^^^^^^^^^^^^^^^^^^^^^^^^^^^^"^^^
^^^^^^^^^^^^^^^^^^^^^^^^^^^^^^^^^^^^^^^"^^*
Ppppppppppppppppppppppppppppppppppppppp/^^^
^^^^^^^^^^^^^^^^^^^^^^^^^^^^^^^^^^^^^^^"^^*
^^^^^^^^^^^^^^^^^^^^^^^^^^^^^^^^^^^^^^^"^^^
^^^^^^^^^^^^^^^^^^^^^^^^^^^^^^^^^^^^^^^"^^^
^^^^^^^^^^^^^^^^^^^^^^^^^^^^^^^^^^^^^^^"^^*
^^^^^^^^^^^^^^^^^^^^^^^^^^^^^^^^^^^^^^^"^**
^^^^^^^^^^^^^^^^^^^^^^^^^^^^^^^^^^^^^^^"^^*
^^^^^^^^^^^^^^^^^^^^^^^^^^^^^^^^^^^^^^^"^^^
***************************************"*^^