[#####]
[-----###]
[--------#####]
[------------->
[------------+]
[-------------]
{#############}