#######
#-----####
#--------######
#------------->
#------------+#
#-------------#
###############