[################%^^^^^^^^
>----------------%^^^^^^^^
[----------------%^^^^^^^^
[----------------%^^^^^^^^
[----------------%^^^^^^^^
{###########---##%^^^^^^^^
?????????[-------%^^^^^^^^
?????????[-------%^^^^^^^^
?????????[-------%^^^^^^^^
?????????[-------%^^^^^^^^
?????????[-------%^^^^^^^^
?????????[-------%^^^^^^^^
?????????[-------%^^^^^^^^
?????????[-------%^^^^^^^^
?????????{#######}^^^^^^^^