[################]
>----------------]
[----------------]
[----------------]
[----------------]
{###########---##]
?????????[-------]
?????????[-------]
?????????[-------]
?????????[-------]
?????????[-------]
?????????[-------]
?????????[-------]
?????????[-------]
?????????{#######}