##########################
>------------------------#
#------------------------#
#------------------------#
#------------------------#
#------------------------#
#------------------------#
#------------------------#
##########################